#S####################
#  K  ################
##### ################
#####     I      #####
################    V#
######################