##############################
#    ######     ### K##### ###
# ## ##     ###       # ######
#S## ###### ###  ###I##V######
####           ##### ## ######
####################    ######
##############################