##############################
#S    ################ #######
#### ##    #####        ######
#### ###########K ##### ######
####      ##     #  ### ######
#########  #  ################
#########  #  ##V       ######
##########   ######## ########
###########I#### #### ########
###########      #### ########
################      ########
##############################
##############################
##############################
##############################
##############################